................#.......
................#.......
................#.......
................#.......
................#.......
................#.......
..M.............#.......
..##............#.......
.........E......#.......
#.......####....#.......
................#.......
................#.......
#######.......###.......
........................
.1..D.........F.......X.
########################